xdxxxxxxxxxxx
xt      p   x
x xx xxx xx x
x x p     x x
x x xxxxx x x
x p xd e  x x
x x     x   x
x x xxxxx x x
x x  p    xpx
x xxx x xxd x
x  p        x
xxxxxxxxxxxxx
