xxxxxxxxxxxxx
x  t    p   x
x xx xxx xx x
x x p  t px x
x x xxdxx x x
xp  xx e  x x
x x  t  x   x
x x xxxxx x x
xtx  p    xpx
x xxx x xxd x
x  p     t xx
xxxxxxxxxxxxx
