xxxxxxxxxxxxx
x  t    p   x
x xx xxx xx x
x x p    px x
x x xxdxx x x
xp  xx e  x x
x x     x   x
x x xxxxx x x
x x  p    xpx
x xxx x xxd x
x  p       xx
xxxxxxxxxxxxx
